33333333333333333333333333333333333333333333333333333333333333333333333333-
33333333333333333333333333333333333333333333333333333333333333333333333333-
33010000000000000000000000000000200000000000000000030000000000000000000033-
33000036000006001000001000000000000000000000000003636000000063000063000033-
33000366003363000003300000600660666000060000200033330002000006300036300033-
33000630036630000003330000000000000000000000000000000000000006660003630033-
33000000006000000033333000400000000020000000001000000000000000663000000033-
33010000066000003333333333333333333333333333333333333333300000006000000033-
33000000000000033333333333333333333333333333333333333333333000000000000033-
33000033000000333300000000000000330000000000000000000000033330000000200033-
33000000000003330000000000000000333000000000000000000400000333000000000033-
33300003000033300000400000000000330000000000000040000060000033300000000033-
33330000000333000000000000006000033000000630000000000063000003330400000033-
33333000003330000000000000063000003300000063000000000006300000333000000033-
33333333333300006660000066633000000330000036660000000003630000033300000033-
33333333333000000660000000000000000330000000036000000000000000003330000033-
66666666600000000060000000000000000000000000003600000000000660000333000033-
00000000000000000000000000000010000000000000000000000000000060000000000000-
00000000000002000000000000000000000000000000000000000000000000000000000000-
66666666600000000000000000001000000330000000000000000000200000000333000033-
33333333330000000000000000000000000033000200000000000000000000003330000033-
33333333333000000000000000000000000003300000000000000000600000033300000033-
33333000033330000003600000000000000000330000000630000066300003333000000033-
33330000000333000000363000000000060000330000003630000000000033300000000033-
33300636000033300000066000000000630003300000006600004000000333000000000033-
33000060000003330000000000000000000033000000000000000000033330000000000033-
33000000000000333000010000000000000003300200000000000000333000000020000033-
33002000000000033300000000000000000033000000000000000003336000000000000033-
33000000000000033333333333333333333333333333333333333333366200000000000033-
33000000000010003333333333333333333333333333333333333333660000000000010033-
33000000660000000000330000000000000000000000000000000033000000036000000033-
33000000363000000000330002000000000000000004000000000330000000363000000033-
33006300036300000000330000000000000000000000000663333330000000630006600033-
33000600000630000000660000000004000000000000000336333333000036300006000033-
33000360000060000000660000000000000000000000000000000033000060000066000033-
33300000000000000000000000660306306000666600000000000033000000020000000333-
33330000000000000000000000000000000000030000000000000000000000000000003333-
33333000000000400066666020000000000000000000000004000000000000000000033333-
33333333333333333333333333333333333333333333333333333333333333333333333333-
33333333333333333333333333333333333333333333333333333333333333333333333333-
