33333333333333333333333333333333333333333333333333333333333333333333333333-
33333333333333333333333333333333333333333333333333333333333333333333333333-
33300000006660000000000333333300066000033000000063333330000000000000333333-
33000400006000100000000033333001000006360000000000003330000002000000033333-
33000000006000000666000033330060000000000000001000000000000000000000003333-
33000660000000000006660033330000000000000000000000000000000000000036000333-
33000660000000000000000033333333000033333333333333333330000000000363000033-
33000000000000000000000033333333000033333333333333333330000000000630000033-
33000000000000000020000000000000000033333333333333333000000020000000040033-
33000006660000000000000000000000000033333333333333330000630000000000000033-
33000000666000000000000033333333333333333333333333300000330006000000000033-
33000000006000000000000033333333333333333333333333000003600006660000060033-
33000000006000000000000033333333333333333333333333000033000000060000630033-
33002000006600000660000033333333333333333333333333020066000000000000600033-
33000000006600000000000033333333333333333333333333000003300000000000000033-
33300000006660400000000333333333333333333333333333000006330000000020000033-
33333333333333333003333333333333333333333333333333333333330033333333333333-
33333333333333333003333333333333333333333333333333333333330033333333333333-
00000000000000033003300000000000033000000000000000000000000000000000000033-
00000000000000033003300000000000033001000000000000600000000000000000000033-
33333333333333333003333333000000033000000000000000660000000000000100000033-
33333333333333333003333333000000033000000333000000066000000000000000000033-
33004000000000000000000033333333333000003333000000000040000000000000600033-
33000000000000000000000033333333333000003330000000000000000000033000000033-
33000003000000000000000000000000033000000000000066000000001000033000000033-
33000063000001000000000000200000033000600000000006000000000000000000200033-
33000063000000000000000000000000033000660000010000000000000000000000000033-
33000633000000000000000006660000033000066000000000000001000004000006600033-
33000000000000000000066666002000033000000000000000000000000000000000000033-
33000000000000400000660000000000033333333333003333333333333333333333333333-
33333333333333333333333333333333333333333333003333333333333333333333333333-
33333333333333333333333333333333333600000000000000000033333333333333333333-
33000660000000000000000000333333360000100000000002000003333333333333333333-
33010000000000200006000000330000000000000000000000000000333333333333333333-
00000000020000000000000000000000000000000000000000000000333333333333333333-
00000000000000000000000000000000000000000002000000660000333333333333333333-
33000020000060000400000000336000004000000000000000060003333333333333333333-
33000000000666000000000000333333360000000000000000000033333333333333333333-
33333333333333333333333333333333333333333333333333333333333333333333333333-
33333333333333333333333333333333333333333333333333333333333333333333333333-
