33333333333333333333333333333333333333333333333333333333333333333333333333-
33333333333333333333333333333333333333333333333333333333333333333333333333-
33000000000000000000000000000000000000000000000000000000000000000000000033-
33000006000006000000000000000000000000000000000000000000000060000060000033-
33000060000060000000000000600660666000060000000000000000000006000006000033-
33000600000600000000000000000000000000000000000000000000000000600000600033-
33000000006000000000000000000000000000000000000000000000000000060000000033-
33000000060000003333333333333333333333333333333333333333300000006000000033-
33000000000000033333333333333333333333333333333333333333333000000000000033-
33000000000000333300000000000000330000000000000000000000033330000000000033-
33000000000003330000000000000000033000000000000000000000000333000000000033-
33300000000033300000000000000000330000000000000000000060000033300000000033-
33330000000333000000000000006000033000000600000000000060000003330000000033-
33333000003330000000000000060000003300000060000000000006000000333000000033-
33333333333300006660000066600000000330000006660000000000600000033300000033-
33333333333000000660000000000000000330000000006000000000000000003330000033-
33366663300000000060000000000000000000000000000600000000000660000333000033-
00000000000000000000000000000000000000000000000000000000000060000000000000-
00000000000000000000000000000000000000000000000000000000000000000000000000-
33666633300000000000000000000000000330000000000000000000000000000333000033-
33333333330000000000000000000000000033000000000000000000000000003330000033-
33333333333000000000000000000000000003300000000000000000600000033300000033-
33333000033330000000600000000000000000330000000600000066000003333000000033-
33330000000333000000060000000000060000330000000600000000000033300000000033-
33300606000033300000006000000000600003300000006000000000000333000000000033-
33000060000003330000000000000000000033000000000000000000033330000000000033-
33000000000000333000000000000000000003300000000000000000333000000000000033-
33000000000000033300000000000000000033000000000000000003336000000000000033-
33000000000000033333333333333333333333333333333333333333366000000000000033-
33000000000000003333333333333333333333333333333333333333660000000000000033-
33000000600000000000000000000000000000000000000000000000000000006000000033-
33000000060000000000000000000000000000000000000000000000000000060000000033-
33006000006000000000000000000000000000000000000660000000000000600000600033-
33000600000600000000000000000000000000000000000006000000000006000006000033-
33000060000060000000000000000000000000000000000000000000000060000060000033-
33300000000000000000000000660006006000666600000000000000000000000000000333-
33330000000000000006000000000000000000000000000000000000000000000000003333-
33333000000000000066600000000000000000000000000000000000000000000000033333-
33333333333333333333333333333333333333333333333333333333333333333333333333-
33333333333333333333333333333333333333333333333333333333333333333333333333-
