33333333333333333333333333333333333333333333333333333333333333333333333333-
33333333333333333333333333333333333333333333333333333333333333333333333333-
33300000006660000000000333333300066000033000000063333330000000000000333333-
33000000006000000000000033333000000006360000000000003330000000000000033333-
33000000006000000666000033330060000000000000000000000000000000000000003333-
33000660000000000006660033330000000000000000000000000000000000000036000333-
33000660000000000000000033333333000033333333333333333330000000000363000033-
33000000000000000000000033333333000033333333333333333330000000000630000033-
33000000000000000000000000000000000033333333333333333000000000000000000033-
33000006660000000000000000000000000033333333333333330000630000000000000033-
33000000666000000000000033333333333333333333333333300000330006000000000033-
33000000006000000000000033333333333333333333333333000003600006660000060033-
33000000006000000000000033333333333333333333333333000033000000060000630033-
33000000006600000660000033333333333333333333333333000066000000000000600033-
33000000006600000000000033333333333333333333333333000003300000000000000033-
33300000006660000000000333333333333333333333333333000006330000000000000033-
33333333333333333003333333333333333333333333333333333333330033333333333333-
33333333333333333003333333333333333333333333333333333333330033333333333333-
00000000000000033003300000000000033000000000000000000000000000000000000033-
00000000000000033003300000000000033000000000000000600000000000000000000033-
33333333333333333003333333000000033000000000000000660000000000000000000033-
33333333333333333003333333000000033000000333000000066000000000000000000033-
33000000000000000000000033333333333000003333000000000000000000000000600033-
33000000000000000000000033333333333000003330000000000000000000033000000033-
33000003000000000000000000000000033000000000000066000000000000033000000033-
33000063000000000000000000000000033000600000000006000000000000000000000033-
33000063000000000000000000000000033000660000000000000000000000000000000033-
33000633000000000000000006660000033000066000000000000000000000000006600033-
33000000000000000000066666000000033000000000000000000000000000000000000033-
33000000000000000000660000000000033333333333003333333333333333333333333333-
33333333333333333333333333333333333333333333003333333333333333333333333333-
33333333333333333333333333333333333600000000000000000033333333333333333333-
33000660000000000000000000333333360000000000000000000003333333333333333333-
33000000000000000006000000330000000000000000000000000000333333333333333333-
00000000000000000000000000000000000000000000000000000000333333333333333333-
00000000000000000000000000000000000000000000000000660000333333333333333333-
33000000000060000000000000336000000000000000000000060003333333333333333333-
33000000000666000000000000333333360000000000000000000033333333333333333333-
33333333333333333333333333333333333333333333333333333333333333333333333333-
33333333333333333333333333333333333333333333333333333333333333333333333333-
