33333333333333333333333333333333333333333333333333333333333333333333333333-
33333333333333333333333333333333333333333333333333333333333333333333333333-
33300000000000000000000333333300000000000000000003333330000000000000333333-
33000000000000000000000033333000000000000000000000003330000000000000033333-
33000000000000000000000033330000000000000000000000000000000000000000003333-
33000000000000000000000033330000000000000000000000000000000000000000000333-
33000000000000000000000033333333000033333333333333333330000000000000000033-
33000000000000000000000033333333000033333333333333333330000000000000000033-
33000000000000000000000000000000000033333333333333333000000000000000000033-
33000000000000000000000000000000000033333333333333330000000000000000000033-
33000000000000000000000033333333333333333333333333300000000000000000000033-
33000000000000000000000033333333333333333333333333000000000000000000000033-
33000000000000000000000033333333333333333333333333000000000000000000000033-
33000000000000000000000033333333333333333333333333000000000000000000000033-
33000000000000000000000033333333333333333333333333000000000000000000000033-
33300000000000000000000333333333333333333333333333000000000000000000000033-
33333333333333333003333333333333333333333333333333333333330033333333333333-
33333333333333333003333333333333333333333333333333333333330033333333333333-
00000000000000033003300000000000033000000000000000000000000000000000000033-
00000000000000033003300000000000033000000000000000000000000000000000000033-
33333333333333333003333333000000033000000000000000000000000000000000000033-
33333333333333333003333333000000033000000333000000000000000000000000000033-
33000000000000000000000033333333333000003333000000000000000000000000000033-
33000000000000000000000033333333333000003330000000000000000000033000000033-
33000000000000000000000000000000033000000000000000000000000000033000000033-
33000000000000000000000000000000033000000000000000000000000000000000000033-
33000000000000000000000000000000033000000000000000000000000000000000000033-
33000000000000000000000000000000033000000000000000000000000000000000000033-
33000000000000000000000000000000033000000000000000000000000000000000000033-
33000000000000000000000000000000033333333333003333333333333333333333333333-
33333333333333333333333333333333333333333333003333333333333333333333333333-
33333333333333333333333333333333333000000000000000000033333333333333333333-
33000000000000000000000000333333300000000000000000000003333333333333333333-
33000000000000000000000000330000000000000000000000000000333333333333333333-
00000000000000000000000000000000000000000000000000000000333333333333333333-
00000000000000000000000000000000000000000000000000000000333333333333333333-
33000000000000000000000000330000000000000000000000000003333333333333333333-
33000000000000000000000000333333300000000000000000000033333333333333333333-
33333333333333333333333333333333333333333333333333333333333333333333333333-
33333333333333333333333333333333333333333333333333333333333333333333333333-
