33333333333333333333333333333333333333333333333333333333333333333333333333-
33333333333333333333333333333333333333333333333333333333333333333333333333-
33000000000033300000000000000000000000000040000333000000400000000200000033-
33000660000003330000600000200000000000030000003330006000066000000000000000-
33000100000000333006300000066630000000036600003330000000036000000060000000-
33000000006000033300000000000060000100000363333300000000000000000060000033-
33020000000000003330000000000000000000000033333000000000000004000060000033-
33000000000000000333002000000000000000003333300000660000000600000000000333-
33000000000000000033300000363000033333333333300000060000006300000001003333-
33000006000000010003330000636000333000000333330000000003333333333333333333-
33000000000000000000333000000003330000003333330033333333333333333333333333-
33304000000000000600033300000033300000033300000000333000000003330000000033-
33330000000000000000003330000333000000333000000003330040000003330000660033-
33333000000000000000000333003330000033300000000033300600060033300000000033-
33333300000000000003333330000033333333000000000333000600000333000000033333-
33003330000000660000000000000000000000000000003330000360003330000000333333-
33000333000000000000000000002000000000100000033300000000033300060000033333-
33000033333333333333000060000000000000000000003330033333333300000400003333-
33000003333333333333300000000000033333366600666333000033333333000000033033-
33000000000000000003300333330030333003336600066633300000000000000000330033-
33000000000000000333000003330033330000333606003663330000003333300003300033-
33000000000000003330000033300000333000033300006000333004000033330000040033-
33000000000000033300000333000000033300003330000000033300000000033000006033-
33333333333333333000003330000000003330000333006600003330006660033003306033-
33333333333333300000033300060010000333000033300000000333006000033003300033-
33333333333330000600033000630000000033300003330000660033300400033003330033-
33000000000000000000033006300000000003330000333000000003333333333000333333-
33000000036000000000033000000006000000330000033306000000033333333300333333-
33000040000000000000333000000003600000330000033300000660000000000000000033-
33000000000000000003330000000000666300330000033300000000000000020000000033-
33000000000004000033300020000000000600333000333040000066006600000000000033-
33020000000006000033000000006000000000033300333000000036006000000200000033-
33006600000006000333000000003600000000003333330000000003666000000000000333-
33000630000000003330000000000360000000000333300000000000000000000000033333-
33000060000000003330006000000000000060000333000000000000000000003333333333-
00000036000000033301066600000000000666000333020066660000000000333333333333-
00000030000100333000000000000000000000000333000000666600010003333333333333-
33000000000003330000000000000000000000040033300000006660000033333333333333-
33333333333333333333333333333333333333333333333333333333333333333333333333-
33333333333333333333333333333333333333333333333333333333333333333333333333-
